27 27 27 27 27 27 27 27 27 27 27 27 27 27 27 27 27 27 27 27 27 27 27 27 27 27 27 27 27 27 27 27 27 27 27 27 27 27 27 27 27 27 27 27 27 27 27 27 27 27 
27 27 27 27 27 27 27 27 27 27 27 27 27 27 27 27 27 27 27 27 27 27 27 27 27 27 27 27 27 27 27 27 27 27 27 27 27 27 27 27 27 27 27 27 27 27 27 27 27 27 
27 27 27 27 27 27 27 27 27 27 27 27 27 27 27 27 27 27 27 27 27 27 27 27 27 27 27 27 27 27 27 27 27 27 27 27 27 27 27 27 27 27 27 27 27 27 27 27 27 27 
27 27 27 27 27 27 27 27 27 27 27 27 27 27 27 27 27 27 27 27 27 27 27 27 27 27 27 27 27 27 27 27 27 27 27 27 27 27 27 27 27 27 27 27 27 27 27 27 27 27 
27 27 27 27 27 27 27 27 27 27 27 27 27 27 27 27 27 27 27 27 27 27 27 27 27 27 27 27 27 27 27 27 27 27 27 27 27 27 27 27 27 27 27 27 27 27 27 27 27 27 
27 27 27 27 27 27 27 27 27 27 27 27 27 27 27 27 27 27 27 27 27 27 27 27 27 27 27 27 27 27 27 27 27 27 27 27 27 27 27 27 27 27 27 27 27 27 27 27 27 27 
27 27 27 27 27 27 27 27 27 27 27 27 27 27 27 27 27 27 27 27 27 27 27 27 27 27 27 27 27 27 27 27 27 27 27 27 27 27 27 27 27 27 27 27 27 27 27 27 27 27 
27 27 27 27 27 27 27 27 27 27 27 27 27 27 27 27 27 27 27 27 27 27 27 27 27 27 27 27 27 27 27 27 27 27 27 27 27 27 27 27 27 27 27 27 27 27 27 27 27 27 
27 27 27 27 27 27 27 27 27 27 27 27 16 54 54 54 54 54 54 54 54 54 54 54 54 54 54 54 54 54 54 54 54 54 54 54 17 27 27 27 27 27 27 27 27 27 27 27 27 27 
27 27 27 27 27 27 27 27 27 27 27 27 35 83 83 83 83 83 83 83 83 83 83 83 83 83 83 83 83 83 83 83 83 83 83 83 33 27 27 27 27 27 27 27 27 27 27 27 27 27 
27 27 27 27 27 27 27 27 27 27 27 27 35 83 83 103 84 84 64 84 84 84 64 64 64 64 83 83 83 83 83 84 83 83 83 83 33 39 27 27 27 27 27 27 27 27 27 27 27 27 
27 27 27 27 27 27 27 27 27 27 27 27 35 83 84 84 84 64 64 84 64 84 84 84 84 103 83 83 103 64 83 84 84 83 83 83 33 39 27 27 27 27 27 27 27 27 27 27 27 27 
27 27 27 27 27 27 27 27 27 27 27 27 35 83 83 103 84 84 64 64 64 83 103 84 84 84 84 84 83 83 64 64 84 83 84 83 33 39 27 27 27 27 27 27 27 27 27 27 27 27 
27 27 27 27 27 27 27 27 27 27 27 27 35 70 83 84 84 84 84 64 84 84 84 84 84 84 83 70 83 83 83 84 84 83 84 83 33 39 27 27 27 27 27 27 27 27 27 27 27 27 
27 27 27 27 27 27 27 27 52 52 27 27 35 70 83 84 84 84 83 84 64 64 83 83 64 70 83 70 83 83 84 84 84 83 84 70 33 27 27 27 27 27 27 27 27 27 27 27 27 27 
27 27 27 27 27 27 27 27 52 52 52 52 35 70 83 70 70 64 105 84 105 70 70 70 83 83 70 84 84 84 83 83 84 83 84 70 33 27 27 27 27 27 27 27 27 27 27 27 27 27 
27 27 27 27 27 27 27 27 52 52 52 52 35 70 70 83 83 64 70 84 70 83 83 70 70 83 84 84 83 84 84 84 84 84 84 70 33 27 27 27 27 27 27 27 27 27 27 27 27 27 
27 27 27 27 27 27 27 27 52 52 52 52 35 70 70 83 64 64 84 84 70 84 70 70 84 84 84 84 84 84 64 84 84 64 84 70 33 27 27 27 27 27 27 27 27 27 27 27 27 27 
27 27 27 27 27 27 27 27 52 52 52 52 35 70 70 83 64 70 64 64 64 84 64 64 84 83 70 64 84 84 84 64 84 84 70 70 33 27 27 27 27 27 27 27 27 27 27 27 27 27 
27 27 27 27 27 27 27 27 52 52 52 52 35 70 70 83 64 64 83 83 83 84 84 64 64 64 84 64 83 84 70 83 84 84 70 70 33 27 27 27 27 27 27 27 27 27 27 27 27 27 
27 27 27 27 27 27 27 27 52 52 52 52 35 70 70 83 64 64 83 83 83 83 83 83 64 64 84 64 84 84 84 84 84 64 70 70 33 27 27 27 27 27 27 27 27 27 27 27 27 27 
27 27 27 27 27 27 27 27 52 52 52 52 35 70 70 83 70 70 83 83 83 83 83 83 83 83 83 84 84 83 83 103 103 84 70 70 33 27 27 27 27 27 27 27 27 27 27 27 27 27 
27 27 27 27 27 27 27 27 52 52 52 52 35 70 70 83 83 83 83 84 84 84 83 83 83 83 83 83 84 84 84 84 84 84 70 70 33 27 27 27 27 27 27 27 27 27 27 27 27 27 
27 27 27 27 27 27 27 27 52 52 52 52 35 70 70 70 64 70 83 64 84 83 83 83 84 84 84 84 84 84 70 70 70 64 70 70 33 27 27 27 27 27 27 27 27 27 27 27 27 27 
27 27 27 27 27 27 27 27 52 52 52 52 35 70 70 70 64 64 64 84 84 64 70 70 70 70 70 70 70 70 70 70 70 70 70 70 33 27 27 27 27 27 27 27 27 27 27 27 27 27 
27 27 27 27 27 27 27 27 52 52 52 52 36 14 14 14 14 14 14 14 14 14 11 11 11 11 11 14 14 14 14 14 14 14 14 14 37 27 27 27 27 27 27 27 27 27 27 27 27 27 
27 27 27 27 27 27 27 27 52 52 52 52 52 52 52 52 52 52 27 27 27 149 107 107 107 107 107 151 27 27 27 52 52 27 27 27 27 27 27 27 27 27 27 27 27 27 27 27 27 27 
27 27 27 27 27 27 27 27 27 52 52 52 52 52 52 52 52 52 27 27 27 149 107 107 107 107 107 151 27 27 27 52 52 27 27 27 27 27 27 27 27 27 27 27 27 27 27 27 27 27 
27 27 27 27 27 27 27 27 27 27 27 27 27 27 27 27 27 124 124 124 124 149 64 64 64 64 64 151 124 124 124 124 52 124 124 27 27 27 27 27 27 27 27 27 27 27 27 27 27 27 
27 27 27 27 27 27 27 27 27 27 27 27 27 27 27 124 124 124 124 124 124 149 64 64 64 64 64 151 124 124 124 27 27 124 124 124 124 124 124 27 27 27 27 27 27 27 27 27 27 27 
27 27 27 27 27 27 27 27 27 27 27 27 27 27 27 124 124 124 124 124 124 149 64 64 64 64 64 151 124 124 124 27 124 124 124 124 124 124 124 27 27 27 27 27 27 27 27 27 27 27 
27 27 27 27 27 27 27 27 27 27 27 27 27 27 27 124 124 124 124 124 124 149 64 64 64 64 64 151 124 124 124 27 124 124 124 124 124 124 124 27 27 27 27 27 27 27 27 27 27 27 
27 27 27 27 27 27 27 27 27 27 27 27 27 27 27 124 124 124 124 124 124 149 64 64 64 64 64 151 124 124 124 27 124 124 124 124 124 124 124 27 27 27 27 27 27 27 27 27 27 27 
27 27 27 27 27 27 27 27 27 27 27 27 27 27 27 27 27 27 27 27 27 149 83 83 83 83 83 151 27 27 27 27 27 27 27 27 27 27 27 27 27 27 27 27 27 27 27 27 27 27 
27 27 27 27 27 27 27 27 27 27 27 27 27 27 27 27 27 27 27 27 27 149 83 83 83 83 83 151 27 27 27 27 27 27 27 27 27 27 27 27 27 27 27 27 27 27 27 27 27 27 
27 27 27 27 27 27 27 27 27 27 27 27 27 27 27 27 27 27 27 27 27 149 83 83 83 83 83 151 27 27 27 27 27 27 27 27 27 27 27 27 27 27 27 27 27 27 27 27 27 27 
27 27 27 27 27 27 27 27 27 27 27 27 27 27 27 27 27 27 27 27 27 149 83 49 50 51 83 151 27 27 27 27 27 27 27 27 27 27 27 27 27 27 27 27 27 27 27 27 27 27 
27 27 27 27 27 27 27 27 27 27 27 27 27 27 27 27 27 27 27 27 27 16 83 69 70 71 83 17 27 27 27 27 27 27 27 27 27 27 27 27 27 27 27 27 27 27 27 27 27 27 
27 27 27 27 27 27 27 27 27 27 27 27 27 27 27 136 136 137 138 26 70 70 70 89 90 91 70 70 70 28 125 126 128 27 27 27 27 27 27 27 27 27 27 27 27 27 27 27 27 27 
27 27 27 27 27 27 27 27 27 27 27 27 27 27 27 155 156 157 158 26 70 70 70 70 70 70 70 70 70 28 145 146 147 148 27 27 27 27 27 27 27 27 27 27 27 27 27 27 27 27 
0 1 1 1 1 1 1 1 1 1 1 1 1 1 5 158 158 158 158 26 70 70 70 70 70 70 70 70 70 28 207 207 207 207 5 1 1 1 1 1 1 1 1 1 1 1 1 1 1 2 
20 21 21 21 21 21 21 21 21 21 21 21 21 21 5 158 158 158 158 7 30 7 7 7 7 7 7 7 7 30 207 207 207 207 5 21 21 21 21 21 21 21 21 21 21 21 21 21 21 22 
20 21 21 21 21 21 21 21 21 21 21 21 21 21 5 215 216 217 218 237 237 237 238 238 238 238 238 238 238 238 205 206 207 208 5 21 21 21 21 21 21 21 21 21 21 21 21 21 21 22 
20 21 21 21 21 21 21 21 21 21 21 21 21 21 5 235 236 237 238 238 238 238 238 238 238 238 238 238 238 238 226 226 227 228 5 21 21 21 21 21 21 21 21 21 21 21 21 21 21 22 
20 21 21 21 21 21 21 21 21 21 21 21 21 21 5 5 5 5 5 5 5 5 5 5 5 5 5 5 5 5 5 5 5 5 5 21 21 21 21 21 21 21 21 21 21 21 21 21 21 22 
20 21 21 21 21 21 21 21 21 21 21 21 21 21 21 21 21 21 21 21 21 21 21 21 21 21 21 21 21 21 21 21 21 21 21 21 21 21 21 21 21 21 21 21 21 21 21 21 21 22 
20 21 21 21 21 21 21 21 21 21 21 21 21 21 21 21 21 21 21 21 21 21 21 21 21 21 21 21 21 21 21 21 21 21 21 21 21 21 21 21 21 21 21 21 21 21 21 21 21 22 
20 21 21 21 21 21 21 21 21 21 21 21 21 21 21 21 21 21 21 21 21 21 21 21 21 21 21 21 21 21 21 21 21 21 21 21 21 21 21 21 21 21 21 21 21 21 21 21 21 22 
20 21 21 21 21 21 21 21 21 21 21 21 21 21 21 21 21 21 21 21 21 21 21 21 21 21 21 21 21 21 21 21 21 21 21 21 21 21 21 21 21 21 21 21 21 21 21 21 21 22 
40 41 41 41 41 41 41 41 41 41 41 41 41 41 41 41 41 41 41 41 41 41 41 41 41 41 41 41 41 41 41 41 41 41 41 41 41 41 41 41 41 41 41 41 41 41 41 41 41 42 
